+--*--*--+--+--+
|              *
+  +-   -+     +
|  |     |     *
+  +--+  +--+  +
|           |  *
+  +--+-**--|  +
|  |           *
+  +--+--+   **+
|        |     g
+--+--+--+--+**+
