####################
#                  #
#     #    #       #
#     #    #       #
#                  #
#                  #
#                  #
#    #######       #
#                  #
#                  #
#                  #
#                  #
#                  #
#                  #
#                  #
#                  #
#                  #
#                  #
####################
